########
###   ##
#*@$  ##
### $*##
#*##$ ##
# # * ##
#$ %$$*#
#   *  #
########
