########
###   ##
#*@$  ##
###$$*##
#  *   #
########
