########
###   ##
#*@$  ##
### $*##
# ##$ ##
# # * ##
#      #
#   *$ #
########