     ###
  ### @#
 #  S  # 
 # S S#
#  ####
# $  $ #
# $ $  *#
 ####### 

