   #####
   #*** #
   ####C##
  # 00  @#
  #0#0#  #
 ##  S00#
#K#0#0# #
#     S #
 ########
