 # ###
#@#K $##
# $0% C #
#$ $ $$ *#
# $ $ $$ #
 # $ $ ##
  ######
