  ###
 # @ #
 #$$$#
#   K#
 #1µ  ##
 #S#$$  #
 #  $ S#
  ###C$ #
    # *#
     ##
