Level 6
43
  ###
 # H #
 #BBB#
#   K#
 #TP  ##
 #M#BB  #
 #  B M#
  ###LB #
    # D#
     ##
