    ##
   # *#
 ## C$ #
#@#2 $ #
# # 2 2#
#S#$$$$#
#2 2  2#
 #####K#
      #
