    #*#
   #   #
  ##$C$##
 #$#$  # #
#$  $$$  K#
# $$$  $$ #
 #@ $  $ #
  #######
