Level 5 (merci à R. Froger)
23
########
   # D#
 ## LB #
#H#T B #
# # T T#
#M#BBBB#
#T T  T#
 #####K#
      #
