  ####
 #    ##
 #S#00  #
# 0##%%$#
#  ## 0 #
#@ ## S #
 ####* S#
     ###
