     ##
    #* ##
  ### C #
 # K#$$$#
 #S$ S$ #
 # #S  @#
 #1##2##
 #2121#
  ####
